year,flgith_movement_dep,flgith_movement_arr,flgith_movement_total,passenger_out,passenger_in,passenger_total
JAN,3378,3380,6758,126227,117904,244131
FEB,3188,3184,6372,116456,109756,226212
MAR,4146,4125,8271,138436,126109,264545
APR,3986,4000,7986,130085,120530,250615
MAY,3934,3930,7864,127061,118788,245849
JUN,3297,3299,6596,128471,121982,250453
JUL,4481,4581,8999,189102,181881,370983
AUG,3616,3615,7231,141189,132996,274185
SEP,4015,4009,8024,150173,134029,284202
OCT,5015,5014,10029,171693,154304,325997
NOV,4622,4632,9254,155468,147397,302865
DEC,3629,3627,7256,137392,129571,266963